"unique_id","pokemon_id","hp","attack","defense","special_attack","special_defense","speed","total_stats"
1,1,45,49,49,65,65,45,318
2,2,60,62,63,80,80,60,405
3,3,80,82,83,100,100,80,525
4,4,39,52,43,60,50,65,309
5,5,58,64,58,80,65,80,405
6,6,78,84,78,109,85,100,534
7,7,44,48,65,50,64,43,314
8,8,59,63,80,65,80,58,405
9,9,79,83,100,85,105,78,530
10,10,45,30,35,20,20,45,195
11,11,50,20,55,25,25,30,205
12,12,60,45,50,90,80,70,395
13,13,40,35,30,20,20,50,195
14,14,45,25,50,25,25,35,205
15,15,65,90,40,45,80,75,395
16,16,40,45,40,35,35,56,251
17,17,63,60,55,50,50,71,349
18,18,83,80,75,70,70,101,479
19,19,30,56,35,25,35,72,253
20,20,55,81,60,50,70,97,413
21,21,40,60,30,31,31,70,262
22,22,65,90,65,61,61,100,442
23,23,35,60,44,40,54,55,288
24,24,60,95,69,65,79,80,448
25,25,35,55,40,50,50,90,320
26,26,60,90,55,90,80,110,485
27,27,50,75,85,20,30,40,300
28,28,75,100,110,45,55,65,450
29,29,55,47,52,40,40,41,275
30,30,70,62,67,55,55,56,365
31,31,90,92,87,75,85,76,505
32,32,46,57,40,40,40,50,273
33,33,61,72,57,55,55,65,365
34,34,81,102,77,85,75,85,505
35,35,70,45,48,60,65,35,323
36,36,95,70,73,95,90,60,483
37,37,38,41,40,50,65,65,299
38,38,73,76,75,81,100,100,505
39,39,115,45,20,45,25,20,270
40,40,140,70,45,85,50,45,435
41,41,40,45,35,30,40,55,245
42,42,75,80,70,65,75,90,455
43,43,45,50,55,75,65,30,320
44,44,60,65,70,85,75,40,395
45,45,75,80,85,110,90,50,490
46,46,35,70,55,45,55,25,285
47,47,60,95,80,60,80,30,405
48,48,60,55,50,40,55,45,305
49,49,70,65,60,90,75,90,450
50,50,10,55,25,35,45,95,265
51,51,35,100,50,50,70,120,425
52,52,40,45,35,40,40,90,290
53,53,65,70,60,65,65,115,440
54,54,50,52,48,65,50,55,320
55,55,80,82,78,95,80,85,500
56,56,40,80,35,35,45,70,305
57,57,65,105,60,60,70,95,455
58,58,55,70,45,70,50,60,350
59,59,90,110,80,100,80,95,555
60,60,40,50,40,40,40,90,300
61,61,65,65,65,50,50,90,385
62,62,90,95,95,70,90,70,510
63,63,25,20,15,105,55,90,310
64,64,40,35,30,120,70,105,400
65,65,55,50,45,135,95,120,500
66,66,70,80,50,35,35,35,305
67,67,80,100,70,50,60,45,405
68,68,90,130,80,65,85,55,505
69,69,50,75,35,70,30,40,300
70,70,65,90,50,85,45,55,390
71,71,80,105,65,100,70,70,490
72,72,40,40,35,50,100,70,335
73,73,80,70,65,80,120,100,515
74,74,40,80,100,30,30,20,300
75,75,55,95,115,45,45,35,390
76,76,80,120,130,55,65,45,495
77,77,50,85,55,65,65,90,410
78,78,65,100,70,80,80,105,500
79,79,90,65,65,40,40,15,315
80,80,95,75,110,100,80,30,490
81,81,25,35,70,95,55,45,325
82,82,50,60,95,120,70,70,465
83,83,52,90,55,58,62,60,377
84,84,35,85,45,35,35,75,310
85,85,60,110,70,60,60,110,470
86,86,65,45,55,45,70,45,325
87,87,90,70,80,70,95,70,475
88,88,80,80,50,40,50,25,325
89,89,105,105,75,65,100,50,500
90,90,30,65,100,45,25,40,305
91,91,50,95,180,85,45,70,525
92,92,30,35,30,100,35,80,310
93,93,45,50,45,115,55,95,405
94,94,60,65,60,130,75,110,500
95,95,35,45,160,30,45,70,385
96,96,60,48,45,43,90,42,328
97,97,85,73,70,73,115,67,483
98,98,30,105,90,25,25,50,325
99,99,55,130,115,50,50,75,475
100,100,40,30,50,55,55,100,330
101,101,60,50,70,80,80,150,490
102,102,60,40,80,60,45,40,325
103,103,95,95,85,125,75,55,530
104,104,50,50,95,40,50,35,320
105,105,60,80,110,50,80,45,425
106,106,50,120,53,35,110,87,455
107,107,50,105,79,35,110,76,455
108,108,90,55,75,60,75,30,385
109,109,40,65,95,60,45,35,340
110,110,65,90,120,85,70,60,490
111,111,80,85,95,30,30,25,345
112,112,105,130,120,45,45,40,485
113,113,250,5,5,35,105,50,450
114,114,65,55,115,100,40,60,435
115,115,105,95,80,40,80,90,490
116,116,30,40,70,70,25,60,295
117,117,55,65,95,95,45,85,440
118,118,45,67,60,35,50,63,320
119,119,80,92,65,65,80,68,450
120,120,30,45,55,70,55,85,340
121,121,60,75,85,100,85,115,520
122,122,40,45,65,100,120,90,460
123,123,70,110,80,55,80,105,500
124,124,65,50,35,115,95,95,455
125,125,65,83,57,95,85,105,490
126,126,65,95,57,100,85,93,495
127,127,65,125,100,55,70,85,500
128,128,75,100,95,40,70,110,490
129,129,20,10,55,15,20,80,200
130,130,95,125,79,60,100,81,540
131,131,130,85,80,85,95,60,535
132,132,48,48,48,48,48,48,288
133,133,55,55,50,45,65,55,325
134,134,130,65,60,110,95,65,525
135,135,65,65,60,110,95,130,525
136,136,65,130,60,95,110,65,525
137,137,65,60,70,85,75,40,395
138,138,35,40,100,90,55,35,355
139,139,70,60,125,115,70,55,495
140,140,30,80,90,55,45,55,355
141,141,60,115,105,65,70,80,495
142,142,80,105,65,60,75,130,515
143,143,160,110,65,65,110,30,540
144,144,90,85,100,95,125,85,580
145,145,90,90,85,125,90,100,580
146,146,90,100,90,125,85,90,580
147,147,41,64,45,50,50,50,300
148,148,61,84,65,70,70,70,420
149,149,91,134,95,100,100,80,600
150,150,106,110,90,154,90,130,680
151,151,100,100,100,100,100,100,600
152,152,45,49,65,49,65,45,318
153,153,60,62,80,63,80,60,405
154,154,80,82,100,83,100,80,525
155,155,39,52,43,60,50,65,309
156,156,58,64,58,80,65,80,405
157,157,78,84,78,109,85,100,534
158,158,50,65,64,44,48,43,314
159,159,65,80,80,59,63,58,405
160,160,85,105,100,79,83,78,530
161,161,35,46,34,35,45,20,215
162,162,85,76,64,45,55,90,415
163,163,60,30,30,36,56,50,262
164,164,100,50,50,86,96,70,452
165,165,40,20,30,40,80,55,265
166,166,55,35,50,55,110,85,390
167,167,40,60,40,40,40,30,250
168,168,70,90,70,60,70,40,400
169,169,85,90,80,70,80,130,535
170,170,75,38,38,56,56,67,330
171,171,125,58,58,76,76,67,460
172,172,20,40,15,35,35,60,205
173,173,50,25,28,45,55,15,218
174,174,90,30,15,40,20,15,210
175,175,35,20,65,40,65,20,245
176,176,55,40,85,80,105,40,405
177,177,40,50,45,70,45,70,320
178,178,65,75,70,95,70,95,470
179,179,55,40,40,65,45,35,280
180,180,70,55,55,80,60,45,365
181,181,90,75,85,115,90,55,510
182,182,75,80,95,90,100,50,490
183,183,70,20,50,20,50,40,250
184,184,100,50,80,60,80,50,420
185,185,70,100,115,30,65,30,410
186,186,90,75,75,90,100,70,500
187,187,35,35,40,35,55,50,250
188,188,55,45,50,45,65,80,340
189,189,75,55,70,55,95,110,460
190,190,55,70,55,40,55,85,360
191,191,30,30,30,30,30,30,180
192,192,75,75,55,105,85,30,425
193,193,65,65,45,75,45,95,390
194,194,55,45,45,25,25,15,210
195,195,95,85,85,65,65,35,430
196,196,65,65,60,130,95,110,525
197,197,95,65,110,60,130,65,525
198,198,60,85,42,85,42,91,405
199,199,95,75,80,100,110,30,490
200,200,60,60,60,85,85,85,435
201,201,48,72,48,72,48,48,336
202,202,190,33,58,33,58,33,405
203,203,70,80,65,90,65,85,455
204,204,50,65,90,35,35,15,290
205,205,75,90,140,60,60,40,465
206,206,100,70,70,65,65,45,415
207,207,65,75,105,35,65,85,430
208,208,75,85,200,55,65,30,510
209,209,60,80,50,40,40,30,300
210,210,90,120,75,60,60,45,450
211,211,65,95,85,55,55,85,440
212,212,70,130,100,55,80,65,500
213,213,20,10,230,10,230,5,505
214,214,80,125,75,40,95,85,500
215,215,55,95,55,35,75,115,430
216,216,60,80,50,50,50,40,330
217,217,90,130,75,75,75,55,500
218,218,40,40,40,70,40,20,250
219,219,60,50,120,90,80,30,430
220,220,50,50,40,30,30,50,250
221,221,100,100,80,60,60,50,450
222,222,65,55,95,65,95,35,410
223,223,35,65,35,65,35,65,300
224,224,75,105,75,105,75,45,480
225,225,45,55,45,65,45,75,330
226,226,85,40,70,80,140,70,485
227,227,65,80,140,40,70,70,465
228,228,45,60,30,80,50,65,330
229,229,75,90,50,110,80,95,500
230,230,75,95,95,95,95,85,540
231,231,90,60,60,40,40,40,330
232,232,90,120,120,60,60,50,500
233,233,85,80,90,105,95,60,515
234,234,73,95,62,85,65,85,465
235,235,55,20,35,20,45,75,250
236,236,35,35,35,35,35,35,210
237,237,50,95,95,35,110,70,455
238,238,45,30,15,85,65,65,305
239,239,45,63,37,65,55,95,360
240,240,45,75,37,70,55,83,365
241,241,95,80,105,40,70,100,490
242,242,255,10,10,75,135,55,540
243,243,90,85,75,115,100,115,580
244,244,115,115,85,90,75,100,580
245,245,100,75,115,90,115,85,580
246,246,50,64,50,45,50,41,300
247,247,70,84,70,65,70,51,410
248,248,100,134,110,95,100,61,600
249,249,106,90,130,90,154,110,680
250,250,106,130,90,110,154,90,680
251,251,100,100,100,100,100,100,600
252,252,40,45,35,65,55,70,310
253,253,50,65,45,85,65,95,405
254,254,70,85,65,105,85,120,530
255,255,45,60,40,70,50,45,310
256,256,60,85,60,85,60,55,405
257,257,80,120,70,110,70,80,530
258,258,50,70,50,50,50,40,310
259,259,70,85,70,60,70,50,405
260,260,100,110,90,85,90,60,535
261,261,35,55,35,30,30,35,220
262,262,70,90,70,60,60,70,420
263,263,38,30,41,30,41,60,240
264,264,78,70,61,50,61,100,420
265,265,45,45,35,20,30,20,195
266,266,50,35,55,25,25,15,205
267,267,60,70,50,100,50,65,395
268,268,50,35,55,25,25,15,205
269,269,60,50,70,50,90,65,385
270,270,40,30,30,40,50,30,220
271,271,60,50,50,60,70,50,340
272,272,80,70,70,90,100,70,480
273,273,40,40,50,30,30,30,220
274,274,70,70,40,60,40,60,340
275,275,90,100,60,90,60,80,480
276,276,40,55,30,30,30,85,270
277,277,60,85,60,75,50,125,455
278,278,40,30,30,55,30,85,270
279,279,60,50,100,95,70,65,440
280,280,28,25,25,45,35,40,198
281,281,38,35,35,65,55,50,278
282,282,68,65,65,125,115,80,518
283,283,40,30,32,50,52,65,269
284,284,70,60,62,100,82,80,454
285,285,60,40,60,40,60,35,295
286,286,60,130,80,60,60,70,460
287,287,60,60,60,35,35,30,280
288,288,80,80,80,55,55,90,440
289,289,150,160,100,95,65,100,670
290,290,31,45,90,30,30,40,266
291,291,61,90,45,50,50,160,456
292,292,1,90,45,30,30,40,236
293,293,64,51,23,51,23,28,240
294,294,84,71,43,71,43,48,360
295,295,104,91,63,91,73,68,490
296,296,72,60,30,20,30,25,237
297,297,144,120,60,40,60,50,474
298,298,50,20,40,20,40,20,190
299,299,30,45,135,45,90,30,375
300,300,50,45,45,35,35,50,260
301,301,70,65,65,55,55,90,400
302,302,50,75,75,65,65,50,380
303,303,50,85,85,55,55,50,380
304,304,50,70,100,40,40,30,330
305,305,60,90,140,50,50,40,430
306,306,70,110,180,60,60,50,530
307,307,30,40,55,40,55,60,280
308,308,60,60,75,60,75,80,410
309,309,40,45,40,65,40,65,295
310,310,70,75,60,105,60,105,475
311,311,60,50,40,85,75,95,405
312,312,60,40,50,75,85,95,405
313,313,65,73,75,47,85,85,430
314,314,65,47,75,73,85,85,430
315,315,50,60,45,100,80,65,400
316,316,70,43,53,43,53,40,302
317,317,100,73,83,73,83,55,467
318,318,45,90,20,65,20,65,305
319,319,70,120,40,95,40,95,460
320,320,130,70,35,70,35,60,400
321,321,170,90,45,90,45,60,500
322,322,60,60,40,65,45,35,305
323,323,70,100,70,105,75,40,460
324,324,70,85,140,85,70,20,470
325,325,60,25,35,70,80,60,330
326,326,80,45,65,90,110,80,470
327,327,60,60,60,60,60,60,360
328,328,45,100,45,45,45,10,290
329,329,50,70,50,50,50,70,340
330,330,80,100,80,80,80,100,520
331,331,50,85,40,85,40,35,335
332,332,70,115,60,115,60,55,475
333,333,45,40,60,40,75,50,310
334,334,75,70,90,70,105,80,490
335,335,73,115,60,60,60,90,458
336,336,73,100,60,100,60,65,458
337,337,90,55,65,95,85,70,460
338,338,90,95,85,55,65,70,460
339,339,50,48,43,46,41,60,288
340,340,110,78,73,76,71,60,468
341,341,43,80,65,50,35,35,308
342,342,63,120,85,90,55,55,468
343,343,40,40,55,40,70,55,300
344,344,60,70,105,70,120,75,500
345,345,66,41,77,61,87,23,355
346,346,86,81,97,81,107,43,495
347,347,45,95,50,40,50,75,355
348,348,75,125,100,70,80,45,495
349,349,20,15,20,10,55,80,200
350,350,95,60,79,100,125,81,540
351,351,70,70,70,70,70,70,420
352,352,60,90,70,60,120,40,440
353,353,44,75,35,63,33,45,295
354,354,64,115,65,83,63,65,455
355,355,20,40,90,30,90,25,295
356,356,40,70,130,60,130,25,455
357,357,99,68,83,72,87,51,460
358,358,75,50,80,95,90,65,455
359,359,65,130,60,75,60,75,465
360,360,95,23,48,23,48,23,260
361,361,50,50,50,50,50,50,300
362,362,80,80,80,80,80,80,480
363,363,70,40,50,55,50,25,290
364,364,90,60,70,75,70,45,410
365,365,110,80,90,95,90,65,530
366,366,35,64,85,74,55,32,345
367,367,55,104,105,94,75,52,485
368,368,55,84,105,114,75,52,485
369,369,100,90,130,45,65,55,485
370,370,43,30,55,40,65,97,330
371,371,45,75,60,40,30,50,300
372,372,65,95,100,60,50,50,420
373,373,95,135,80,110,80,100,600
374,374,40,55,80,35,60,30,300
375,375,60,75,100,55,80,50,420
376,376,80,135,130,95,90,70,600
377,377,80,100,200,50,100,50,580
378,378,80,50,100,100,200,50,580
379,379,80,75,150,75,150,50,580
380,380,80,80,90,110,130,110,600
381,381,80,90,80,130,110,110,600
382,382,100,100,90,150,140,90,670
383,383,100,150,140,100,90,90,670
384,384,105,150,90,150,90,95,680
385,385,100,100,100,100,100,100,600
386,386,50,150,50,150,50,150,600
387,387,55,68,64,45,55,31,318
388,388,75,89,85,55,65,36,405
389,389,95,109,105,75,85,56,525
390,390,44,58,44,58,44,61,309
391,391,64,78,52,78,52,81,405
392,392,76,104,71,104,71,108,534
393,393,53,51,53,61,56,40,314
394,394,64,66,68,81,76,50,405
395,395,84,86,88,111,101,60,530
396,396,40,55,30,30,30,60,245
397,397,55,75,50,40,40,80,340
398,398,85,120,70,50,60,100,485
399,399,59,45,40,35,40,31,250
400,400,79,85,60,55,60,71,410
401,401,37,25,41,25,41,25,194
402,402,77,85,51,55,51,65,384
403,403,45,65,34,40,34,45,263
404,404,60,85,49,60,49,60,363
405,405,80,120,79,95,79,70,523
406,406,40,30,35,50,70,55,280
407,407,60,70,65,125,105,90,515
408,408,67,125,40,30,30,58,350
409,409,97,165,60,65,50,58,495
410,410,30,42,118,42,88,30,350
411,411,60,52,168,47,138,30,495
412,412,40,29,45,29,45,36,224
413,413,60,59,85,79,105,36,424
414,414,70,94,50,94,50,66,424
415,415,30,30,42,30,42,70,244
416,416,70,80,102,80,102,40,474
417,417,60,45,70,45,90,95,405
418,418,55,65,35,60,30,85,330
419,419,85,105,55,85,50,115,495
420,420,45,35,45,62,53,35,275
421,421,70,60,70,87,78,85,450
422,422,76,48,48,57,62,34,325
423,423,111,83,68,92,82,39,475
424,424,75,100,66,60,66,115,482
425,425,90,50,34,60,44,70,348
426,426,150,80,44,90,54,80,498
427,427,55,66,44,44,56,85,350
428,428,65,76,84,54,96,105,480
429,429,60,60,60,105,105,105,495
430,430,100,125,52,105,52,71,505
431,431,49,55,42,42,37,85,310
432,432,71,82,64,64,59,112,452
433,433,45,30,50,65,50,45,285
434,434,63,63,47,41,41,74,329
435,435,103,93,67,71,61,84,479
436,436,57,24,86,24,86,23,300
437,437,67,89,116,79,116,33,500
438,438,50,80,95,10,45,10,290
439,439,20,25,45,70,90,60,310
440,440,100,5,5,15,65,30,220
441,441,76,65,45,92,42,91,411
442,442,50,92,108,92,108,35,485
443,443,58,70,45,40,45,42,300
444,444,68,90,65,50,55,82,410
445,445,108,130,95,80,85,102,600
446,446,135,85,40,40,85,5,390
447,447,40,70,40,35,40,60,285
448,448,70,110,70,115,70,90,525
449,449,68,72,78,38,42,32,330
450,450,108,112,118,68,72,47,525
451,451,40,50,90,30,55,65,330
452,452,70,90,110,60,75,95,500
453,453,48,61,40,61,40,50,300
454,454,83,106,65,86,65,85,490
455,455,74,100,72,90,72,46,454
456,456,49,49,56,49,61,66,330
457,457,69,69,76,69,86,91,460
458,458,45,20,50,60,120,50,345
459,459,60,62,50,62,60,40,334
460,460,90,92,75,92,85,60,494
461,461,70,120,65,45,85,125,510
462,462,70,70,115,130,90,60,535
463,463,110,85,95,80,95,50,515
464,464,115,140,130,55,55,40,535
465,465,100,100,125,110,50,50,535
466,466,75,123,67,95,85,95,540
467,467,75,95,67,125,95,83,540
468,468,85,50,95,120,115,80,545
469,469,86,76,86,116,56,95,515
470,470,65,110,130,60,65,95,525
471,471,65,60,110,130,95,65,525
472,472,75,95,125,45,75,95,510
473,473,110,130,80,70,60,80,530
474,474,85,80,70,135,75,90,535
475,475,68,125,65,65,115,80,518
476,476,60,55,145,75,150,40,525
477,477,45,100,135,65,135,45,525
478,478,70,80,70,80,70,110,480
479,479,50,50,77,95,77,91,440
480,480,75,75,130,75,130,95,580
481,481,80,105,105,105,105,80,580
482,482,75,125,70,125,70,115,580
483,483,100,120,120,150,100,90,680
484,484,90,120,100,150,120,100,680
485,485,91,90,106,130,106,77,600
486,486,110,160,110,80,110,100,670
487,487,150,100,120,100,120,90,680
488,488,120,70,110,75,120,85,580
489,489,80,80,80,80,80,80,480
490,490,100,100,100,100,100,100,600
491,491,70,90,90,135,90,125,600
492,492,100,100,100,100,100,100,600
493,493,120,120,120,120,120,120,720
494,494,100,100,100,100,100,100,600
495,495,45,45,55,45,55,63,308
496,496,60,60,75,60,75,83,413
497,497,75,75,95,75,95,113,528
498,498,65,63,45,45,45,45,308
499,499,90,93,55,70,55,55,418
500,500,110,123,65,100,65,65,528
501,501,55,55,45,63,45,45,308
502,502,75,75,60,83,60,60,413
503,503,95,100,85,108,70,70,528
504,504,45,55,39,35,39,42,255
505,505,60,85,69,60,69,77,420
506,506,45,60,45,25,45,55,275
507,507,65,80,65,35,65,60,370
508,508,85,110,90,45,90,80,500
509,509,41,50,37,50,37,66,281
510,510,64,88,50,88,50,106,446
511,511,50,53,48,53,48,64,316
512,512,75,98,63,98,63,101,498
513,513,50,53,48,53,48,64,316
514,514,75,98,63,98,63,101,498
515,515,50,53,48,53,48,64,316
516,516,75,98,63,98,63,101,498
517,517,76,25,45,67,55,24,292
518,518,116,55,85,107,95,29,487
519,519,50,55,50,36,30,43,264
520,520,62,77,62,50,42,65,358
521,521,80,115,80,65,55,93,488
522,522,45,60,32,50,32,76,295
523,523,75,100,63,80,63,116,497
524,524,55,75,85,25,25,15,280
525,525,70,105,105,50,40,20,390
526,526,85,135,130,60,80,25,515
527,527,65,45,43,55,43,72,323
528,528,67,57,55,77,55,114,425
529,529,60,85,40,30,45,68,328
530,530,110,135,60,50,65,88,508
531,531,103,60,86,60,86,50,445
532,532,75,80,55,25,35,35,305
533,533,85,105,85,40,50,40,405
534,534,105,140,95,55,65,45,505
535,535,50,50,40,50,40,64,294
536,536,75,65,55,65,55,69,384
537,537,105,95,75,85,75,74,509
538,538,120,100,85,30,85,45,465
539,539,75,125,75,30,75,85,465
540,540,45,53,70,40,60,42,310
541,541,55,63,90,50,80,42,380
542,542,75,103,80,70,80,92,500
543,543,30,45,59,30,39,57,260
544,544,40,55,99,40,79,47,360
545,545,60,100,89,55,69,112,485
546,546,40,27,60,37,50,66,280
547,547,60,67,85,77,75,116,480
548,548,45,35,50,70,50,30,280
549,549,70,60,75,110,75,90,480
550,550,70,92,65,80,55,98,460
551,551,50,72,35,35,35,65,292
552,552,60,82,45,45,45,74,351
553,553,95,117,80,65,70,92,519
554,554,70,90,45,15,45,50,315
555,555,105,140,55,30,55,95,480
556,556,75,86,67,106,67,60,461
557,557,50,65,85,35,35,55,325
558,558,70,105,125,65,75,45,485
559,559,50,75,70,35,70,48,348
560,560,65,90,115,45,115,58,488
561,561,72,58,80,103,80,97,490
562,562,38,30,85,55,65,30,303
563,563,58,50,145,95,105,30,483
564,564,54,78,103,53,45,22,355
565,565,74,108,133,83,65,32,495
566,566,55,112,45,74,45,70,401
567,567,75,140,65,112,65,110,567
568,568,50,50,62,40,62,65,329
569,569,80,95,82,60,82,75,474
570,570,40,65,40,80,40,65,330
571,571,60,105,60,120,60,105,510
572,572,55,50,40,40,40,75,300
573,573,75,95,60,65,60,115,470
574,574,45,30,50,55,65,45,290
575,575,60,45,70,75,85,55,390
576,576,70,55,95,95,110,65,490
577,577,45,30,40,105,50,20,290
578,578,65,40,50,125,60,30,370
579,579,110,65,75,125,85,30,490
580,580,62,44,50,44,50,55,305
581,581,75,87,63,87,63,98,473
582,582,36,50,50,65,60,44,305
583,583,51,65,65,80,75,59,395
584,584,71,95,85,110,95,79,535
585,585,60,60,50,40,50,75,335
586,586,80,100,70,60,70,95,475
587,587,55,75,60,75,60,103,428
588,588,50,75,45,40,45,60,315
589,589,70,135,105,60,105,20,495
590,590,69,55,45,55,55,15,294
591,591,114,85,70,85,80,30,464
592,592,55,40,50,65,85,40,335
593,593,100,60,70,85,105,60,480
594,594,165,75,80,40,45,65,470
595,595,50,47,50,57,50,65,319
596,596,70,77,60,97,60,108,472
597,597,44,50,91,24,86,10,305
598,598,74,94,131,54,116,20,489
599,599,40,55,70,45,60,30,300
600,600,60,80,95,70,85,50,440
601,601,60,100,115,70,85,90,520
602,602,35,55,40,45,40,60,275
603,603,65,85,70,75,70,40,405
604,604,85,115,80,105,80,50,515
605,605,55,55,55,85,55,30,335
606,606,75,75,75,125,95,40,485
607,607,50,30,55,65,55,20,275
608,608,60,40,60,95,60,55,370
609,609,60,55,90,145,90,80,520
610,610,46,87,60,30,40,57,320
611,611,66,117,70,40,50,67,410
612,612,76,147,90,60,70,97,540
613,613,55,70,40,60,40,40,305
614,614,95,130,80,70,80,50,505
615,615,80,50,50,95,135,105,515
616,616,50,40,85,40,65,25,305
617,617,80,70,40,100,60,145,495
618,618,109,66,84,81,99,32,471
619,619,45,85,50,55,50,65,350
620,620,65,125,60,95,60,105,510
621,621,77,120,90,60,90,48,485
622,622,59,74,50,35,50,35,303
623,623,89,124,80,55,80,55,483
624,624,45,85,70,40,40,60,340
625,625,65,125,100,60,70,70,490
626,626,95,110,95,40,95,55,490
627,627,70,83,50,37,50,60,350
628,628,100,123,75,57,75,80,510
629,629,70,55,75,45,65,60,370
630,630,110,65,105,55,95,80,510
631,631,85,97,66,105,66,65,484
632,632,58,109,112,48,48,109,484
633,633,52,65,50,45,50,38,300
634,634,72,85,70,65,70,58,420
635,635,92,105,90,125,90,98,600
636,636,55,85,55,50,55,60,360
637,637,85,60,65,135,105,100,550
638,638,91,90,129,90,72,108,580
639,639,91,129,90,72,90,108,580
640,640,91,90,72,90,129,108,580
641,641,79,115,70,125,80,111,580
642,642,79,115,70,125,80,111,580
643,643,100,120,100,150,120,90,680
644,644,100,150,120,120,100,90,680
645,645,89,125,90,115,80,101,600
646,646,125,130,90,130,90,95,660
647,647,91,72,90,129,90,108,580
648,648,100,77,77,128,128,90,600
649,649,71,120,95,120,95,99,600
650,650,56,61,65,48,45,38,313
651,651,61,78,95,56,58,57,405
652,652,88,107,122,74,75,64,530
653,653,40,45,40,62,60,60,307
654,654,59,59,58,90,70,73,409
655,655,75,69,72,114,100,104,534
656,656,41,56,40,62,44,71,314
657,657,54,63,52,83,56,97,405
658,658,72,95,67,103,71,122,530
659,659,38,36,38,32,36,57,237
660,660,85,56,77,50,77,78,423
661,661,45,50,43,40,38,62,278
662,662,62,73,55,56,52,84,382
663,663,78,81,71,74,69,126,499
664,664,38,35,40,27,25,35,200
665,665,45,22,60,27,30,29,213
666,666,80,52,50,90,50,89,411
667,667,62,50,58,73,54,72,369
668,668,86,68,72,109,66,106,507
669,669,44,38,39,61,79,42,303
670,670,54,45,47,75,98,52,371
671,671,78,65,68,112,154,75,552
672,672,66,65,48,62,57,52,350
673,673,123,100,62,97,81,68,531
674,674,67,82,62,46,48,43,348
675,675,95,124,78,69,71,58,495
676,676,75,80,60,65,90,102,472
677,677,62,48,54,63,60,68,355
678,678,74,48,76,83,81,104,466
679,679,45,80,100,35,37,28,325
680,680,59,110,150,45,49,35,448
681,681,60,50,140,50,140,60,500
682,682,78,52,60,63,65,23,341
683,683,101,72,72,99,89,29,462
684,684,62,48,66,59,57,49,341
685,685,82,80,86,85,75,72,480
686,686,53,54,53,37,46,45,288
687,687,86,92,88,68,75,73,482
688,688,42,52,67,39,56,50,306
689,689,72,105,115,54,86,68,500
690,690,50,60,60,60,60,30,320
691,691,65,75,90,97,123,44,494
692,692,50,53,62,58,63,44,330
693,693,71,73,88,120,89,59,500
694,694,44,38,33,61,43,70,289
695,695,62,55,52,109,94,109,481
696,696,58,89,77,45,45,48,362
697,697,82,121,119,69,59,71,521
698,698,77,59,50,67,63,46,362
699,699,123,77,72,99,92,58,521
700,700,95,65,65,110,130,60,525
701,701,78,92,75,74,63,118,500
702,702,67,58,57,81,67,101,431
703,703,50,50,150,50,150,50,500
704,704,45,50,35,55,75,40,300
705,705,68,75,53,83,113,60,452
706,706,90,100,70,110,150,80,600
707,707,57,80,91,80,87,75,470
708,708,43,70,48,50,60,38,309
709,709,85,110,76,65,82,56,474
710,710,49,66,70,44,55,51,335
711,711,65,90,122,58,75,84,494
712,712,55,69,85,32,35,28,304
713,713,95,117,184,44,46,28,514
714,714,40,30,35,45,40,55,245
715,715,85,70,80,97,80,123,535
716,716,126,131,95,131,98,99,680
717,717,126,131,95,131,98,99,680
718,718,108,100,121,81,95,95,600
719,719,50,100,150,100,150,50,600
720,720,80,110,60,150,130,70,600
721,721,80,110,120,130,90,70,600
722,722,68,55,55,50,50,42,320
723,723,78,75,75,70,70,52,420
724,724,78,107,75,100,100,70,530
725,725,45,65,40,60,40,70,320
726,726,65,85,50,80,50,90,420
727,727,95,115,90,80,90,60,530
728,728,50,54,54,66,56,40,320
729,729,60,69,69,91,81,50,420
730,730,80,74,74,126,116,60,530
731,731,35,75,30,30,30,65,265
732,732,55,85,50,40,50,75,355
733,733,80,120,75,75,75,60,485
734,734,48,70,30,30,30,45,253
735,735,88,110,60,55,60,45,418
736,736,47,62,45,55,45,46,300
737,737,57,82,95,55,75,36,400
738,738,77,70,90,145,75,43,500
739,739,47,82,57,42,47,63,338
740,740,97,132,77,62,67,43,478
741,741,75,70,70,98,70,93,476
742,742,40,45,40,55,40,84,304
743,743,60,55,60,95,70,124,464
744,744,45,65,40,30,40,60,280
745,745,75,115,65,55,65,112,487
746,746,45,20,20,25,25,40,175
747,747,50,53,62,43,52,45,305
748,748,50,63,152,53,142,35,495
749,749,70,100,70,45,55,45,385
750,750,100,125,100,55,85,35,500
751,751,38,40,52,40,72,27,269
752,752,68,70,92,50,132,42,454
753,753,40,55,35,50,35,35,250
754,754,70,105,90,80,90,45,480
755,755,40,35,55,65,75,15,285
756,756,60,45,80,90,100,30,405
757,757,48,44,40,71,40,77,320
758,758,68,64,60,111,60,117,480
759,759,70,75,50,45,50,50,340
760,760,120,125,80,55,60,60,500
761,761,42,30,38,30,38,32,210
762,762,52,40,48,40,48,62,290
763,763,72,120,98,50,98,72,510
764,764,51,52,90,82,110,100,485
765,765,90,60,80,90,110,60,490
766,766,100,120,90,40,60,80,490
767,767,25,35,40,20,30,80,230
768,768,75,125,140,60,90,40,530
769,769,55,55,80,70,45,15,320
770,770,85,75,110,100,75,35,480
771,771,55,60,130,30,130,5,410
772,772,95,95,95,95,95,59,534
773,773,95,95,95,95,95,95,570
774,774,60,60,100,60,100,60,440
775,775,65,115,65,75,95,65,480
776,776,60,78,135,91,85,36,485
777,777,65,98,63,40,73,96,435
778,778,55,90,80,50,105,96,476
779,779,68,105,70,70,70,92,475
780,780,78,60,85,135,91,36,485
781,781,70,131,100,86,90,40,517
782,782,45,55,65,45,45,45,300
783,783,55,75,90,65,70,65,420
784,784,75,110,125,100,105,85,600
785,785,70,115,85,95,75,130,570
786,786,70,85,75,130,115,95,570
787,787,70,130,115,85,95,75,570
788,788,70,75,115,95,130,85,570
789,789,43,29,31,29,31,37,200
790,790,43,29,131,29,131,37,400
791,791,137,137,107,113,89,97,680
792,792,137,113,89,137,107,97,680
793,793,109,53,47,127,131,103,570
794,794,107,139,139,53,53,79,570
795,795,71,137,37,137,37,151,570
796,796,83,89,71,173,71,83,570
797,797,97,101,103,107,101,61,570
798,798,59,181,131,59,31,109,570
799,799,223,101,53,97,53,43,570
800,800,97,107,101,127,89,79,600
801,801,80,95,115,130,115,65,600
802,802,90,125,80,90,90,125,600
803,803,67,73,67,73,67,73,420
804,804,73,73,73,127,73,121,540
805,805,61,131,211,53,101,13,570
806,806,53,127,53,151,79,107,570
807,807,88,112,75,102,80,143,600
808,808,46,65,65,55,35,34,300
809,809,135,143,143,80,65,34,600
810,810,50,65,50,40,40,65,310
811,811,70,85,70,55,60,80,420
812,812,100,125,90,60,70,85,530
813,813,50,71,40,40,40,69,310
814,814,65,86,60,55,60,94,420
815,815,80,116,75,65,75,119,530
816,816,50,40,40,70,40,70,310
817,817,65,60,55,95,55,90,420
818,818,70,85,65,125,65,120,530
819,819,70,55,55,35,35,25,275
820,820,120,95,95,55,75,20,460
821,821,38,47,35,33,35,57,245
822,822,68,67,55,43,55,77,365
823,823,98,87,105,53,85,67,495
824,824,25,20,20,25,45,45,180
825,825,50,35,80,50,90,30,335
826,826,60,45,110,80,120,90,505
827,827,40,28,28,47,52,50,245
828,828,70,58,58,87,92,90,455
829,829,40,40,60,40,60,10,250
830,830,60,50,90,80,120,60,460
831,831,42,40,55,40,45,48,270
832,832,72,80,100,60,90,88,490
833,833,50,64,50,38,38,44,284
834,834,90,115,90,48,68,74,485
835,835,59,45,50,40,50,26,270
836,836,69,90,60,90,60,121,490
837,837,30,40,50,40,50,30,240
838,838,80,60,90,60,70,50,410
839,839,110,80,120,80,90,30,510
840,840,40,40,80,40,40,20,260
841,841,70,110,80,95,60,70,485
842,842,110,85,80,100,80,30,485
843,843,52,57,75,35,50,46,315
844,844,72,107,125,65,70,71,510
845,845,70,85,55,85,95,85,475
846,846,41,63,40,40,30,66,280
847,847,61,123,60,60,50,136,490
848,848,40,38,35,54,35,40,242
849,849,75,98,70,114,70,75,502
850,850,50,65,45,50,50,45,305
851,851,100,115,65,90,90,65,525
852,852,50,68,60,50,50,32,310
853,853,80,118,90,70,80,42,480
854,854,40,45,45,74,54,50,308
855,855,60,65,65,134,114,70,508
856,856,42,30,45,56,53,39,265
857,857,57,40,65,86,73,49,370
858,858,57,90,95,136,103,29,510
859,859,45,45,30,55,40,50,265
860,860,65,60,45,75,55,70,370
861,861,95,120,65,95,75,60,510
862,862,93,90,101,60,81,95,520
863,863,70,110,100,50,60,50,440
864,864,60,95,50,145,130,30,510
865,865,62,135,95,68,82,65,507
866,866,80,85,75,110,100,70,520
867,867,58,95,145,50,105,30,483
868,868,45,40,40,50,61,34,270
869,869,65,60,75,110,121,64,495
870,870,65,100,100,70,60,75,470
871,871,48,101,95,91,85,15,435
872,872,30,25,35,45,30,20,185
873,873,70,65,60,125,90,65,475
874,874,100,125,135,20,20,70,470
875,875,75,80,110,65,90,50,470
876,876,60,65,55,105,95,95,475
877,877,58,95,58,70,58,97,436
878,878,72,80,49,40,49,40,330
879,879,122,130,69,80,69,30,500
880,880,90,100,90,80,70,75,505
881,881,90,100,90,90,80,55,505
882,882,90,90,100,70,80,75,505
883,883,90,90,100,80,90,55,505
884,884,70,95,115,120,50,85,535
885,885,28,60,30,40,30,82,270
886,886,68,80,50,60,50,102,410
887,887,88,120,75,100,75,142,600
888,888,92,120,115,80,115,138,660
889,889,92,120,115,80,115,138,660
890,890,140,85,95,145,95,130,690
891,891,60,90,60,53,50,72,385
892,892,100,130,100,63,60,97,550
893,893,105,120,105,70,95,105,600
894,894,80,100,50,100,50,200,580
895,895,200,100,50,100,50,80,580
896,896,100,145,130,65,110,30,580
897,897,100,65,60,145,80,130,580
898,898,100,80,80,80,80,80,500
899,899,103,105,72,105,75,65,525
900,900,70,135,95,45,70,85,500
901,901,130,140,105,45,80,50,550
902,902,120,112,65,80,75,78,530
903,903,80,130,60,40,80,120,510
904,904,85,115,95,65,65,85,510
905,905,74,115,70,135,80,106,580
906,906,40,61,54,45,45,65,310
907,907,61,80,63,60,63,83,410
908,908,76,110,70,81,70,123,530
909,909,67,45,59,63,40,36,310
910,910,81,55,78,90,58,49,411
911,911,104,75,100,110,75,66,530
912,912,55,65,45,50,45,50,310
913,913,70,85,65,65,60,65,410
914,914,85,120,80,85,75,85,530
915,915,54,45,40,35,45,35,254
916,916,110,100,75,59,80,65,489
917,917,35,41,45,29,40,20,210
918,918,60,79,92,52,86,35,404
919,919,33,46,40,21,25,45,210
920,920,71,102,78,52,55,92,450
921,921,45,50,20,40,25,60,240
922,922,60,75,40,50,40,85,350
923,923,70,115,70,70,60,105,490
924,924,50,50,45,40,45,75,305
925,925,74,75,70,65,75,111,470
926,926,37,55,70,30,55,65,312
927,927,57,80,115,50,80,95,477
928,928,41,35,45,58,51,30,260
929,929,52,53,60,78,78,33,354
930,930,78,69,90,125,109,39,510
931,931,82,96,51,45,51,92,417
932,932,55,55,75,35,35,25,280
933,933,60,60,100,35,65,35,355
934,934,100,100,130,45,90,35,500
935,935,40,50,40,50,40,35,255
936,936,85,60,100,125,80,75,525
937,937,75,125,80,60,100,85,525
938,938,61,31,41,59,35,45,272
939,939,109,64,91,103,83,45,495
940,940,40,40,35,55,40,70,280
941,941,70,70,60,105,60,125,490
942,942,60,78,60,40,51,51,340
943,943,80,120,90,60,70,85,505
944,944,40,65,35,40,35,75,290
945,945,63,95,65,80,72,110,485
946,946,40,65,30,45,35,60,275
947,947,55,115,70,80,70,90,480
948,948,40,40,35,50,100,70,335
949,949,80,70,65,80,120,100,515
950,950,70,100,115,35,55,75,450
951,951,50,62,40,62,40,50,304
952,952,65,108,65,108,65,75,486
953,953,41,50,60,31,58,30,270
954,954,75,50,85,115,100,45,470
955,955,30,35,30,55,30,75,255
956,956,95,60,60,101,60,105,481
957,957,50,45,45,35,64,58,297
958,958,65,55,55,45,82,78,380
959,959,85,75,77,70,105,94,506
960,960,10,55,25,35,25,95,245
961,961,35,100,50,50,70,120,425
962,962,70,103,85,60,85,82,485
963,963,70,45,40,45,40,75,315
964,964,100,70,72,53,62,100,457
965,965,45,70,63,30,45,47,300
966,966,80,119,90,54,67,90,500
967,967,70,95,65,85,65,121,501
968,968,70,85,145,60,55,65,480
969,969,48,35,42,105,60,60,350
970,970,83,55,90,130,81,86,525
971,971,50,61,60,30,55,34,290
972,972,72,101,100,50,97,68,488
973,973,82,115,74,75,64,90,500
974,974,108,68,45,30,40,43,334
975,975,170,113,65,45,55,73,521
976,976,90,102,73,78,65,70,478
977,977,150,100,115,65,65,35,530
978,978,68,50,60,120,95,82,475
979,979,110,115,80,50,90,90,535
980,980,130,75,60,45,100,20,430
981,981,120,90,70,110,70,60,520
982,982,125,100,80,85,75,55,520
983,983,100,135,120,60,85,50,550
984,984,115,131,131,53,53,87,570
985,985,115,65,99,65,115,111,570
986,986,111,127,99,79,99,55,570
987,987,55,55,55,135,135,135,570
988,988,85,135,79,85,105,81,570
989,989,85,81,97,121,85,101,570
990,990,90,112,120,72,70,106,570
991,991,56,80,114,124,60,136,570
992,992,154,140,108,50,68,50,570
993,993,94,80,86,122,80,108,570
994,994,80,70,60,140,110,110,570
995,995,100,134,110,70,84,72,570
996,996,65,75,45,35,45,55,320
997,997,90,95,66,45,65,62,423
998,998,115,145,92,75,86,87,600
999,999,45,30,70,75,70,10,300
1000,1000,87,60,95,133,91,84,550
1001,1001,85,85,100,95,135,70,570
1002,1002,80,120,80,90,65,135,570
1003,1003,155,110,125,55,80,45,570
1004,1004,55,80,80,135,120,100,570
1005,1005,105,139,71,55,101,119,590
1006,1006,74,130,90,120,60,116,590
1007,1007,100,135,115,85,100,135,670
1008,1008,100,85,100,135,115,135,670
1009,1009,99,83,91,125,83,109,590
1010,1010,90,130,88,70,108,104,590
1011,1011,80,80,110,95,80,40,485
1012,1012,40,45,45,74,54,50,308
1013,1013,71,60,106,121,80,70,508
1014,1014,88,128,115,58,86,80,555
1015,1015,88,75,66,130,90,106,555
1016,1016,88,91,82,70,125,99,555
1017,1017,80,120,84,60,96,110,550
1018,1018,90,105,130,125,65,85,600
1019,1019,106,80,110,120,80,44,540
1020,1020,105,115,121,65,93,91,590
1021,1021,125,73,91,137,89,75,590
1022,1022,90,120,80,68,108,124,590
1023,1023,90,72,100,122,108,98,590
1024,1024,90,65,85,65,85,60,450
1025,1025,88,88,160,88,88,88,600
1026,1,45,49,49,65,65,45,318
1027,2,60,62,63,80,80,60,405
1028,3,80,82,83,100,100,80,525
1029,6,78,84,78,109,85,100,534
1030,12,60,45,50,90,80,70,395
1031,13,40,35,30,20,20,50,195
1032,14,45,25,50,25,25,35,205
1033,15,65,90,40,45,80,75,395
1034,16,40,45,40,35,35,56,251
1035,17,63,60,55,50,50,71,349
1036,18,83,80,75,70,70,101,479
1037,21,40,60,30,31,31,70,262
1038,22,65,90,65,61,61,100,442
1039,31,90,92,87,75,85,76,505
1040,34,81,102,77,85,75,85,505
1041,39,115,45,20,45,25,20,270
1042,40,140,70,45,85,50,45,435
1043,41,40,45,35,30,40,55,245
1044,42,75,80,70,65,75,90,455
1045,43,45,50,55,75,65,30,320
1046,44,60,65,70,85,75,40,395
1047,45,75,80,85,110,90,50,490
1048,46,35,70,55,45,55,25,285
1049,47,60,95,80,60,80,30,405
1050,48,60,55,50,40,55,45,305
1051,49,70,65,60,90,75,90,450
1052,62,90,95,95,70,90,70,510
1053,69,50,75,35,70,30,40,300
1054,70,65,90,50,85,45,55,390
1055,71,80,105,65,100,70,70,490
1056,72,40,40,35,50,100,70,335
1057,73,80,70,65,80,120,100,515
1058,74,40,80,100,30,30,20,300
1059,75,55,95,115,45,45,35,390
1060,76,80,120,130,55,65,45,495
1061,79,90,65,65,40,40,15,315
1062,80,95,75,110,100,80,30,490
1063,81,25,35,70,95,55,45,325
1064,82,50,60,95,120,70,70,465
1065,83,52,90,55,58,62,60,377
1066,84,35,85,45,35,35,75,310
1067,85,60,110,70,60,60,110,470
1068,87,90,70,80,70,95,70,475
1069,91,50,95,180,85,45,70,525
1070,92,30,35,30,100,35,80,310
1071,93,45,50,45,115,55,95,405
1072,94,60,65,60,130,75,110,500
1073,95,35,45,160,30,45,70,385
1074,102,60,40,80,60,45,40,325
1075,103,95,95,85,125,75,55,530
1076,111,80,85,95,30,30,25,345
1077,112,105,130,120,45,45,40,485
1078,121,60,75,85,100,85,115,520
1079,122,40,45,65,100,120,90,460
1080,123,70,110,80,55,80,105,500
1081,124,65,50,35,115,95,95,455
1082,130,95,125,79,60,100,81,540
1083,131,130,85,80,85,95,60,535
1084,138,35,40,100,90,55,35,355
1085,139,70,60,125,115,70,55,495
1086,140,30,80,90,55,45,55,355
1087,141,60,115,105,65,70,80,495
1088,142,80,105,65,60,75,130,515
1089,144,90,85,100,95,125,85,580
1090,145,90,90,85,125,90,100,580
1091,146,90,100,90,125,85,90,580
1092,149,91,134,95,100,100,80,600
1093,163,60,30,30,36,56,50,262
1094,164,100,50,50,86,96,70,452
1095,165,40,20,30,40,80,55,265
1096,166,55,35,50,55,110,85,390
1097,167,40,60,40,40,40,30,250
1098,168,70,90,70,60,70,40,400
1099,169,85,90,80,70,80,130,535
1100,170,75,38,38,56,56,67,330
1101,171,125,58,58,76,76,67,460
1102,174,90,30,15,40,20,15,210
1103,176,55,40,85,80,105,40,405
1104,177,40,50,45,70,45,70,320
1105,178,65,75,70,95,70,95,470
1106,183,70,20,50,20,50,40,250
1107,184,100,50,80,60,80,50,420
1108,187,35,35,40,35,55,50,250
1109,188,55,45,50,45,65,80,340
1110,189,75,55,70,55,95,110,460
1111,193,65,65,45,75,45,95,390
1112,194,55,45,45,25,25,15,210
1113,195,95,85,85,65,65,35,430
1114,198,60,85,42,85,42,91,405
1115,199,95,75,80,100,110,30,490
1116,203,70,80,65,90,65,85,455
1117,205,75,90,140,60,60,40,465
1118,207,65,75,105,35,65,85,430
1119,208,75,85,200,55,65,30,510
1120,211,65,95,85,55,55,85,440
1121,212,70,130,100,55,80,65,500
1122,213,20,10,230,10,230,5,505
1123,214,80,125,75,40,95,85,500
1124,215,55,95,55,35,75,115,430
1125,219,60,50,120,90,80,30,430
1126,220,50,50,40,30,30,50,250
1127,221,100,100,80,60,60,50,450
1128,222,65,55,95,65,95,35,410
1129,225,45,55,45,65,45,75,330
1130,226,85,40,70,80,140,70,485
1131,227,65,80,140,40,70,70,465
1132,228,45,60,30,80,50,65,330
1133,229,75,90,50,110,80,95,500
1134,230,75,95,95,95,95,85,540
1135,238,45,30,15,85,65,65,305
1136,246,50,64,50,45,50,41,300
1137,247,70,84,70,65,70,51,410
1138,248,100,134,110,95,100,61,600
1139,249,106,90,130,90,154,110,680
1140,250,106,130,90,110,154,90,680
1141,251,100,100,100,100,100,100,600
1142,256,60,85,60,85,60,55,405
1143,257,80,120,70,110,70,80,530
1144,259,70,85,70,60,70,50,405
1145,260,100,110,90,85,90,60,535
1146,267,60,70,50,100,50,65,395
1147,269,60,50,70,50,90,65,385
1148,270,40,30,30,40,50,30,220
1149,271,60,50,50,60,70,50,340
1150,272,80,70,70,90,100,70,480
1151,274,70,70,40,60,40,60,340
1152,275,90,100,60,90,60,80,480
1153,276,40,55,30,30,30,85,270
1154,277,60,85,60,75,50,125,455
1155,278,40,30,30,55,30,85,270
1156,279,60,50,100,95,70,65,440
1157,280,28,25,25,45,35,40,198
1158,281,38,35,35,65,55,50,278
1159,282,68,65,65,125,115,80,518
1160,283,40,30,32,50,52,65,269
1161,284,70,60,62,100,82,80,454
1162,286,60,130,80,60,60,70,460
1163,290,31,45,90,30,30,40,266
1164,291,61,90,45,50,50,160,456
1165,292,1,90,45,30,30,40,236
1166,298,50,20,40,20,40,20,190
1167,302,50,75,75,65,65,50,380
1168,303,50,85,85,55,55,50,380
1169,304,50,70,100,40,40,30,330
1170,305,60,90,140,50,50,40,430
1171,306,70,110,180,60,60,50,530
1172,307,30,40,55,40,55,60,280
1173,308,60,60,75,60,75,80,410
1174,315,50,60,45,100,80,65,400
1175,318,45,90,20,65,20,65,305
1176,319,70,120,40,95,40,95,460
1177,322,60,60,40,65,45,35,305
1178,323,70,100,70,105,75,40,460
1179,329,50,70,50,50,50,70,340
1180,330,80,100,80,80,80,100,520
1181,332,70,115,60,115,60,55,475
1182,333,45,40,60,40,75,50,310
1183,334,75,70,90,70,105,80,490
1184,337,90,55,65,95,85,70,460
1185,338,90,95,85,55,65,70,460
1186,339,50,48,43,46,41,60,288
1187,340,110,78,73,76,71,60,468
1188,342,63,120,85,90,55,55,468
1189,343,40,40,55,40,70,55,300
1190,344,60,70,105,70,120,75,500
1191,345,66,41,77,61,87,23,355
1192,346,86,81,97,81,107,43,495
1193,347,45,95,50,40,50,75,355
1194,348,75,125,100,70,80,45,495
1195,357,99,68,83,72,87,51,460
1196,363,70,40,50,55,50,25,290
1197,364,90,60,70,75,70,45,410
1198,365,110,80,90,95,90,65,530
1199,369,100,90,130,45,65,55,485
1200,373,95,135,80,110,80,100,600
1201,374,40,55,80,35,60,30,300
1202,375,60,75,100,55,80,50,420
1203,376,80,135,130,95,90,70,600
1204,380,80,80,90,110,130,110,600
1205,381,80,90,80,130,110,110,600
1206,384,105,150,90,150,90,95,680
1207,385,100,100,100,100,100,100,600
1208,389,95,109,105,75,85,56,525
1209,391,64,78,52,78,52,81,405
1210,392,76,104,71,104,71,108,534
1211,395,84,86,88,111,101,60,530
1212,396,40,55,30,30,30,60,245
1213,397,55,75,50,40,40,80,340
1214,398,85,120,70,50,60,100,485
1215,400,79,85,60,55,60,71,410
1216,406,40,30,35,50,70,55,280
1217,407,60,70,65,125,105,90,515
1218,410,30,42,118,42,88,30,350
1219,411,60,52,168,47,138,30,495
1220,413,60,59,85,79,105,36,424
1221,414,70,94,50,94,50,66,424
1222,415,30,30,42,30,42,70,244
1223,416,70,80,102,80,102,40,474
1224,423,111,83,68,92,82,39,475
1225,425,90,50,34,60,44,70,348
1226,426,150,80,44,90,54,80,498
1227,430,100,125,52,105,52,71,505
1228,434,63,63,47,41,41,74,329
1229,435,103,93,67,71,61,84,479
1230,436,57,24,86,24,86,23,300
1231,437,67,89,116,79,116,33,500
1232,439,20,25,45,70,90,60,310
1233,441,76,65,45,92,42,91,411
1234,442,50,92,108,92,108,35,485
1235,443,58,70,45,40,45,42,300
1236,444,68,90,65,50,55,82,410
1237,445,108,130,95,80,85,102,600
1238,448,70,110,70,115,70,90,525
1239,451,40,50,90,30,55,65,330
1240,452,70,90,110,60,75,95,500
1241,453,48,61,40,61,40,50,300
1242,454,83,106,65,86,65,85,490
1243,458,45,20,50,60,120,50,345
1244,459,60,62,50,62,60,40,334
1245,460,90,92,75,92,85,60,494
1246,461,70,120,65,45,85,125,510
1247,462,70,70,115,130,90,60,535
1248,464,115,140,130,55,55,40,535
1249,468,85,50,95,120,115,80,545
1250,469,86,76,86,116,56,95,515
1251,472,75,95,125,45,75,95,510
1252,473,110,130,80,70,60,80,530
1253,475,68,125,65,65,115,80,518
1254,476,60,55,145,75,150,40,525
1255,478,70,80,70,80,70,110,480
1256,479,50,50,77,95,77,91,440
1257,483,100,120,120,150,100,90,680
1258,484,90,120,100,150,120,100,680
1259,485,91,90,106,130,106,77,600
1260,487,150,100,120,100,120,90,680
1261,494,100,100,100,100,100,100,600
1262,499,90,93,55,70,55,55,418
1263,500,110,123,65,100,65,65,528
1264,519,50,55,50,36,30,43,264
1265,520,62,77,62,50,42,65,358
1266,521,80,115,80,65,55,93,488
1267,527,65,45,43,55,43,72,323
1268,528,67,57,55,77,55,114,425
1269,530,110,135,60,50,65,88,508
1270,536,75,65,55,65,55,69,384
1271,537,105,95,75,85,75,74,509
1272,540,45,53,70,40,60,42,310
1273,541,55,63,90,50,80,42,380
1274,542,75,103,80,70,80,92,500
1275,543,30,45,59,30,39,57,260
1276,544,40,55,99,40,79,47,360
1277,545,60,100,89,55,69,112,485
1278,546,40,27,60,37,50,66,280
1279,547,60,67,85,77,75,116,480
1280,551,50,72,35,35,35,65,292
1281,552,60,82,45,45,45,74,351
1282,553,95,117,80,65,70,92,519
1283,557,50,65,85,35,35,55,325
1284,558,70,105,125,65,75,45,485
1285,559,50,75,70,35,70,48,348
1286,560,65,90,115,45,115,58,488
1287,561,72,58,80,103,80,97,490
1288,564,54,78,103,53,45,22,355
1289,565,74,108,133,83,65,32,495
1290,566,55,112,45,74,45,70,401
1291,567,75,140,65,112,65,110,567
1292,580,62,44,50,44,50,55,305
1293,581,75,87,63,87,63,98,473
1294,585,60,60,50,40,50,75,335
1295,586,80,100,70,60,70,95,475
1296,587,55,75,60,75,60,103,428
1297,589,70,135,105,60,105,20,495
1298,590,69,55,45,55,55,15,294
1299,591,114,85,70,85,80,30,464
1300,592,55,40,50,65,85,40,335
1301,593,100,60,70,85,105,60,480
1302,595,50,47,50,57,50,65,319
1303,596,70,77,60,97,60,108,472
1304,597,44,50,91,24,86,10,305
1305,598,74,94,131,54,116,20,489
1306,607,50,30,55,65,55,20,275
1307,608,60,40,60,95,60,55,370
1308,609,60,55,90,145,90,80,520
1309,618,109,66,84,81,99,32,471
1310,622,59,74,50,35,50,35,303
1311,623,89,124,80,55,80,55,483
1312,624,45,85,70,40,40,60,340
1313,625,65,125,100,60,70,70,490
1314,627,70,83,50,37,50,60,350
1315,628,100,123,75,57,75,80,510
1316,629,70,55,75,45,65,60,370
1317,630,110,65,105,55,95,80,510
1318,632,58,109,112,48,48,109,484
1319,633,52,65,50,45,50,38,300
1320,634,72,85,70,65,70,58,420
1321,635,92,105,90,125,90,98,600
1322,636,55,85,55,50,55,60,360
1323,637,85,60,65,135,105,100,550
1324,638,91,90,129,90,72,108,580
1325,639,91,129,90,72,90,108,580
1326,640,91,90,72,90,129,108,580
1327,642,79,115,70,125,80,111,580
1328,643,100,120,100,150,120,90,680
1329,644,100,150,120,120,100,90,680
1330,645,89,125,90,115,80,101,600
1331,646,125,130,90,130,90,95,660
1332,647,91,72,90,129,90,108,580
1333,648,100,77,77,128,128,90,600
1334,649,71,120,95,120,95,99,600
1335,652,88,107,122,74,75,64,530
1336,655,75,69,72,114,100,104,534
1337,658,72,95,67,103,71,122,530
1338,660,85,56,77,50,77,78,423
1339,661,45,50,43,40,38,62,278
1340,662,62,73,55,56,52,84,382
1341,663,78,81,71,74,69,126,499
1342,666,80,52,50,90,50,89,411
1343,667,62,50,58,73,54,72,369
1344,668,86,68,72,109,66,106,507
1345,675,95,124,78,69,71,58,495
1346,679,45,80,100,35,37,28,325
1347,680,59,110,150,45,49,35,448
1348,681,60,50,140,50,140,60,500
1349,686,53,54,53,37,46,45,288
1350,687,86,92,88,68,75,73,482
1351,688,42,52,67,39,56,50,306
1352,689,72,105,115,54,86,68,500
1353,690,50,60,60,60,60,30,320
1354,691,65,75,90,97,123,44,494
1355,694,44,38,33,61,43,70,289
1356,695,62,55,52,109,94,109,481
1357,696,58,89,77,45,45,48,362
1358,697,82,121,119,69,59,71,521
1359,698,77,59,50,67,63,46,362
1360,699,123,77,72,99,92,58,521
1361,701,78,92,75,74,63,118,500
1362,702,67,58,57,81,67,101,431
1363,703,50,50,150,50,150,50,500
1364,707,57,80,91,80,87,75,470
1365,708,43,70,48,50,60,38,309
1366,709,85,110,76,65,82,56,474
1367,710,49,66,70,44,55,51,335
1368,711,65,90,122,58,75,84,494
1369,714,40,30,35,45,40,55,245
1370,715,85,70,80,97,80,123,535
1371,717,126,131,95,131,98,99,680
1372,718,108,100,121,81,95,95,600
1373,719,50,100,150,100,150,50,600
1374,720,80,110,60,150,130,70,600
1375,721,80,110,120,130,90,70,600
1376,722,68,55,55,50,50,42,320
1377,723,78,75,75,70,70,52,420
1378,724,78,107,75,100,100,70,530
1379,727,95,115,90,80,90,60,530
1380,730,80,74,74,126,116,60,530
1381,731,35,75,30,30,30,65,265
1382,732,55,85,50,40,50,75,355
1383,733,80,120,75,75,75,60,485
1384,737,57,82,95,55,75,36,400
1385,738,77,70,90,145,75,43,500
1386,740,97,132,77,62,67,43,478
1387,741,75,70,70,98,70,93,476
1388,742,40,45,40,55,40,84,304
1389,743,60,55,60,95,70,124,464
1390,747,50,53,62,43,52,45,305
1391,748,50,63,152,53,142,35,495
1392,751,38,40,52,40,72,27,269
1393,752,68,70,92,50,132,42,454
1394,755,40,35,55,65,75,15,285
1395,756,60,45,80,90,100,30,405
1396,757,48,44,40,71,40,77,320
1397,758,68,64,60,111,60,117,480
1398,759,70,75,50,45,50,50,340
1399,760,120,125,80,55,60,60,500
1400,765,90,60,80,90,110,60,490
1401,767,25,35,40,20,30,80,230
1402,768,75,125,140,60,90,40,530
1403,769,55,55,80,70,45,15,320
1404,770,85,75,110,100,75,35,480
1405,774,60,60,100,60,100,60,440
1406,776,60,78,135,91,85,36,485
1407,777,65,98,63,40,73,96,435
1408,778,55,90,80,50,105,96,476
1409,779,68,105,70,70,70,92,475
1410,780,78,60,85,135,91,36,485
1411,781,70,131,100,86,90,40,517
1412,783,55,75,90,65,70,65,420
1413,784,75,110,125,100,105,85,600
1414,785,70,115,85,95,75,130,570
1415,786,70,85,75,130,115,95,570
1416,787,70,130,115,85,95,75,570
1417,788,70,75,115,95,130,85,570
1418,791,137,137,107,113,89,97,680
1419,792,137,113,89,137,107,97,680
1420,793,109,53,47,127,131,103,570
1421,794,107,139,139,53,53,79,570
1422,795,71,137,37,137,37,151,570
1423,797,97,101,103,107,101,61,570
1424,798,59,181,131,59,31,109,570
1425,799,223,101,53,97,53,43,570
1426,801,80,95,115,130,115,65,600
1427,802,90,125,80,90,90,125,600
1428,804,73,73,73,127,73,121,540
1429,805,61,131,211,53,101,13,570
1430,806,53,127,53,151,79,107,570
1431,823,98,87,105,53,85,67,495
1432,825,50,35,80,50,90,30,335
1433,826,60,45,110,80,120,90,505
1434,834,90,115,90,48,68,74,485
1435,838,80,60,90,60,70,50,410
1436,839,110,80,120,80,90,30,510
1437,840,40,40,80,40,40,20,260
1438,841,70,110,80,95,60,70,485
1439,842,110,85,80,100,80,30,485
1440,845,70,85,55,85,95,85,475
1441,848,40,38,35,54,35,40,242
1442,849,75,98,70,114,70,75,502
1443,850,50,65,45,50,50,45,305
1444,851,100,115,65,90,90,65,525
1445,858,57,90,95,136,103,29,510
1446,859,45,45,30,55,40,50,265
1447,860,65,60,45,75,55,70,370
1448,861,95,120,65,95,75,60,510
1449,862,93,90,101,60,81,95,520
1450,866,80,85,75,110,100,70,520
1451,867,58,95,145,50,105,30,483
1452,872,30,25,35,45,30,20,185
1453,873,70,65,60,125,90,65,475
1454,876,60,65,55,105,95,95,475
1455,877,58,95,58,70,58,97,436
1456,880,90,100,90,80,70,75,505
1457,881,90,100,90,90,80,55,505
1458,882,90,90,100,70,80,75,505
1459,883,90,90,100,80,90,55,505
1460,884,70,95,115,120,50,85,535
1461,885,28,60,30,40,30,82,270
1462,886,68,80,50,60,50,102,410
1463,887,88,120,75,100,75,142,600
1464,890,140,85,95,145,95,130,690
1465,892,100,130,100,63,60,97,550
1466,893,105,120,105,70,95,105,600
1467,898,100,80,80,80,80,80,500
1468,899,103,105,72,105,75,65,525
1469,900,70,135,95,45,70,85,500
1470,901,130,140,105,45,80,50,550
1471,902,120,112,65,80,75,78,530
1472,903,80,130,60,40,80,120,510
1473,904,85,115,95,65,65,85,510
1474,905,74,115,70,135,80,106,580
1475,908,76,110,70,81,70,123,530
1476,911,104,75,100,110,75,66,530
1477,914,85,120,80,85,75,85,530
1478,920,71,102,78,52,55,92,450
1479,922,60,75,40,50,40,85,350
1480,923,70,115,70,70,60,105,490
1481,928,41,35,45,58,51,30,260
1482,929,52,53,60,78,78,33,354
1483,930,78,69,90,125,109,39,510
1484,931,82,96,51,45,51,92,417
1485,936,85,60,100,125,80,75,525
1486,937,75,125,80,60,100,85,525
1487,940,40,40,35,55,40,70,280
1488,941,70,70,60,105,60,125,490
1489,944,40,65,35,40,35,75,290
1490,945,63,95,65,80,72,110,485
1491,946,40,65,30,45,35,60,275
1492,947,55,115,70,80,70,90,480
1493,948,40,40,35,50,100,70,335
1494,949,80,70,65,80,120,100,515
1495,952,65,108,65,108,65,75,486
1496,954,75,50,85,115,100,45,470
1497,957,50,45,45,35,64,58,297
1498,958,65,55,55,45,82,78,380
1499,959,85,75,77,70,105,94,506
1500,962,70,103,85,60,85,82,485
1501,965,45,70,63,30,45,47,300
1502,966,80,119,90,54,67,90,500
1503,967,70,95,65,85,65,121,501
1504,969,48,35,42,105,60,60,350
1505,970,83,55,90,130,81,86,525
1506,973,82,115,74,75,64,90,500
1507,976,90,102,73,78,65,70,478
1508,978,68,50,60,120,95,82,475
1509,979,110,115,80,50,90,90,535
1510,980,130,75,60,45,100,20,430
1511,981,120,90,70,110,70,60,520
1512,983,100,135,120,60,85,50,550
1513,984,115,131,131,53,53,87,570
1514,985,115,65,99,65,115,111,570
1515,986,111,127,99,79,99,55,570
1516,987,55,55,55,135,135,135,570
1517,988,85,135,79,85,105,81,570
1518,989,85,81,97,121,85,101,570
1519,990,90,112,120,72,70,106,570
1520,991,56,80,114,124,60,136,570
1521,992,154,140,108,50,68,50,570
1522,993,94,80,86,122,80,108,570
1523,994,80,70,60,140,110,110,570
1524,995,100,134,110,70,84,72,570
1525,996,65,75,45,35,45,55,320
1526,997,90,95,66,45,65,62,423
1527,998,115,145,92,75,86,87,600
1528,1000,87,60,95,133,91,84,550
1529,1001,85,85,100,95,135,70,570
1530,1002,80,120,80,90,65,135,570
1531,1003,155,110,125,55,80,45,570
1532,1004,55,80,80,135,120,100,570
1533,1005,105,139,71,55,101,119,590
1534,1006,74,130,90,120,60,116,590
1535,1007,100,135,115,85,100,135,670
1536,1008,100,85,100,135,115,135,670
1537,1009,99,83,91,125,83,109,590
1538,1010,90,130,88,70,108,104,590
1539,1011,80,80,110,95,80,40,485
1540,1012,40,45,45,74,54,50,308
1541,1013,71,60,106,121,80,70,508
1542,1014,88,128,115,58,86,80,555
1543,1015,88,75,66,130,90,106,555
1544,1016,88,91,82,70,125,99,555
1545,1018,90,105,130,125,65,85,600
1546,1019,106,80,110,120,80,44,540
1547,1020,105,115,121,65,93,91,590
1548,1021,125,73,91,137,89,75,590
1549,1022,90,120,80,68,108,124,590
1550,1023,90,72,100,122,108,98,590
1551,1025,88,88,160,88,88,88,600
